NO ./textures/NORTH.xpm

SO ./textures/SOUTH.xpm


WE ./textures/WEST.xpm
EA ./textures/EAST.xpm

F 220,100,0
C 225,30,0
W 1,1,1

111111
100W11
111111


