NO ./textures/NORTH.xpm

SO ./textures/SOUTH.xpm


WE ./textures/WEST.xpm
EA ./textures/EAST.xpm

F 220,100,0
C 225,30,0
W 1,1,1

  11111111
11110S00111111
1111111111111

11
11
11

1