111111111111111
101001000000001
101001000000001
10100N000100001
101000000010001
100001000001001
100000001000001
111111111111111