111111111111111
101001000000001
101001000000001
101000001000011
101000000010001
100001000001001
1000000010000N1
111111111111111