NO ./textures/NORTH.xpm

SO ./textures/SOUTH.xpm


WE ./textures/WEST.xpm
EA ./textures/EAST.xpm

F 220,100,0
C 225,30,0
W 1,1,1

1111111111111111
1011001000000011
1010010000000011
1010000010000111
1010000000101111
10000100000100111111111111
1000000010000W11
1111111111111111
1
1


