NO ./textures/NORTH.xpm

SO ./textures/SOUTH.xpm


WE ./textures/WEST.xpm
EA ./textures/EAST.xpm

F 220,100,0
C 225,30,0
W 1,1,1

111111111111111
101100100000001
101001000000001
101000001000011111111
101000000010111
100001000001001
1000000010000W1
111111111111111
1
1

