111111111111111
101001000000001
101001000000001
101000000100001
101000000010001
100001000001001
100000001000N01
111111111111111