NO ./textures/NORTH.xpm

SO ./textures/SOUTH.xpm


KAKA ./textures/WEST.xpm
EA ./textures/EAST.xpm

F 220,100,0
C 225,30,0
W 255, 255, 255

111111111111111
101001000000001
101001000000001
101000001000011
101000000010001
100001000001001
1000000010000W1
111111111111111