NO ressources/xpm/utils/wall.xpm
SO ressources/xpm/utils/wall.xpm
WE ressources/xpm/utils/wall.xpm
EA ressources/xpm/utils/wall.xpm
F 96,64,32
C 132,164,240
B 0,0,50

111111111111111111111111111111111111111111111111111111111111111111111111111111111111111111111111
1E0000000000000000000000000000000000000PD000000000000000000000000000000000000PD000000000000000M1
111111111111111111111111111111111111111111111111111111111111111111111111111111111111111111111111