NO ressources/xpm/utils/wall.xpm
SO ressources/xpm/utils/wall.xpm
WE ressources/xpm/utils/wall.xpm
EA ressources/xpm/utils/wall.xpm
F 96,64,32
C 132,164,128

111111111111111
1000000D0000001
1011111111111B1
10100D000000101
101011111110101
101010000010101
101010111010101
101010100010101
101010101110101
10101M100000101
101011111111101
101000000000001
101111111111111
1000000000000W1
111111111111111