NO ressources/xpm/utils/lb_NORTH.xpm
SO ressources/xpm/utils/lb_SOUTH.xpm
WE ressources/xpm/utils/lb_EAST.xpm
EA ressources/xpm/utils/lb_WEST.xpm
F 96,64,32
C 132,164,128

      11111    
    110PPPP11    
   100K000K001  
  1PP0000P00001 
 10000000000P001
10000222D22200001
100002PPPPP200001
10P002PK00P200001
10K00DK0N0PD000012222222111
100002P0M0P20P00D0000000D01
100002KPP0P2000012222222101
10000222D22200001       101
 100000000000001        101
  10P00000P0001         101
   100K000K001          101
    100000001111111111112D2
     1111110000000000000001
111111111111111111111111111