NO ressources/xpm/utils/lb_NORTH.xpm
SO ressources/xpm/utils/lb_SOUTH.xpm
WE ressources/xpm/utils/lb_EAST.xpm
EA ressources/xpm/utils/lb_WEST.xpm
F 180,100,130
C 50,20,155
B 0,0,0
11111111111111111111111111111111111111111111111111
10000000000000000000000000000000000000000000000001
10000000000000000000000000000000000000000000000001
10000000000000M00000000000000000000000M00000000001
10000000000000000000000000000000000000000000000001
10000000000000000000000000000000000000000000000001
100000000000000000000000N0000M00000000000000000001
10000000000000000000000000000000000000000000000001
1000000000000000000M000000000000000000000000000001
10000000000000000000000000000000000000000000000001
10000000000000000000000000000000000000000000000001
10000000000000000000000000000000000000000000000001
10000000000000000000000000000000000000000000000001
10000000000000000000000000000000000000000000000001
11111111111111111111111111111111111111111111111111