NO ressources/xpm/utils/lb_NORTH.xpm
SO ressources/xpm/utils/lb_SOUTH.xpm
WE ressources/xpm/utils/lb_EAST.xpm
EA ressources/xpm/utils/lb_WEST.xpm
F 96,64,32
C 32,64,128
1111111111111111111111111
100000000M11MMM0000000001    
1011000001110P00000M00001
10M100000000000000000000111111111
11111111101100E001110000000000001
10000000001100000111011D111111111
1111011D111111011100000010001
1111011D111111011101010010001
11000000110101011100000010001
100M0000000000001100000010001
10000000000000001101010010001
110000011101M101111101111000111
11110111 1110101 101111010001
11111111 1111111 111111111111